14 14 14 14 14 14 14 14 14 14 14 14 14 14 14 14 14 14 14 14 14 14 14 14 14 14 14 14 14 14 14 14 14 14 14 14 14 14 14 14 14 14 14 14 14 14 14 14 14 14 
14 14 14 14 14 14 14 14 14 14 14 14 14 14 14 14 14 14 14 14 14 14 14 14 14 14 14 14 14 14 14 14 14 14 14 14 14 14 14 14 14 14 14 14 14 14 14 14 14 14 
14 14 14 14 14 14 14 14 14 14 14 14 14 14 14 14 14 14 14 14 14 14 14 14 14 14 14 14 14 14 14 14 14 14 14 14 14 14 14 14 14 14 14 14 14 14 14 14 14 14 
14 14 14 14 14 14 14 14 14 14 14 10 10 10 10 10 10 10 10 10 10 10 10 10 10 10 10 10 10 10 10 10 10 10 10 10 10 10 10 14 14 14 14 14 14 14 14 14 14 14 
14 14 14 14 14 14 14 14 10 10 10 10 10 10 10 10 10 10 10 10 10 10 14 10 10 10 11 11 10 10 10 10 10 10 10 14 10 10 10 10 10 10 10 14 14 14 14 14 14 14 
14 14 14 14 14 14 14 10 10 10 10 10 13 10 10 10 10 10 10 10 10 10 10 10 10 10 10 11 10 10 10 10 10 10 10 10 10 10 14 10 10 10 10 10 10 14 14 14 14 14 
14 14 14 14 14 10 10 10 10 10 10 10 10 14 14 14 14 14 14 14 10 10 10 10 10 10 14 10 10 10 10 10 10 10 13 10 10 10 10 10 10 10 10 10 10 14 14 14 14 14 
14 14 14 14 14 10 10 10 10 10 10 14 14 14 14 14 14 14 14 14 14 14 14 14 10 10 10 10 10 10 10 10 10 10 10 10 10 10 10 10 10 10 10 10 10 14 14 14 14 14 
14 14 14 14 10 10 10 10 10 10 14 14 14 14 14 14 14 14 14 14 14 14 14 14 10 10 10 10 10 10 10 10 11 10 10 10 10 11 11 11 14 10 10 10 10 14 14 14 14 14 
14 14 14 14 10 10 10 10 10 10 14 14 14 14 14 14 14 14 14 14 14 14 14 14 10 10 10 10 13 10 10 10 11 10 10 10 10 10 11 11 10 10 10 10 10 10 14 14 14 14 
14 14 14 14 10 10 10 10 10 10 10 14 14 14 14 14 14 14 14 14 14 14 14 10 10 10 10 10 10 10 10 10 10 10 10 10 10 10 10 10 10 10 10 10 10 10 14 14 14 14 
14 14 14 10 10 10 10 10 10 10 10 14 14 14 14 14 14 14 14 14 14 10 10 10 10 10 10 10 10 10 10 14 10 10 10 10 10 10 10 10 10 10 10 10 10 10 10 14 14 14 
14 14 14 10 11 11 10 10 10 10 10 10 10 14 14 14 14 14 14 14 10 10 10 10 10 10 14 10 10 10 10 10 10 10 10 10 10 10 10 10 10 10 10 10 10 10 10 14 14 14 
14 14 14 10 11 11 12 10 10 10 10 11 10 10 10 10 11 11 11 10 10 10 10 10 10 10 14 14 10 10 10 10 10 10 10 10 10 10 14 10 10 10 10 10 10 10 10 14 14 14 
14 14 14 10 11 11 11 10 10 10 10 10 10 10 10 10 11 10 10 10 10 10 10 13 10 10 10 10 10 10 10 10 10 10 10 10 10 10 10 10 10 10 10 10 10 10 10 14 14 14 
14 14 14 10 10 10 10 10 10 10 10 10 10 10 10 10 10 10 10 10 10 10 10 10 10 10 10 10 10 10 10 14 10 10 10 10 10 10 10 10 10 10 10 10 10 10 10 14 14 14 
14 14 14 10 10 10 10 10 10 10 14 14 14 14 14 14 14 10 10 10 10 10 10 10 10 10 10 10 10 10 10 10 10 10 10 10 10 10 10 10 10 10 10 10 10 10 10 14 14 14 
14 14 14 10 10 10 10 10 14 14 14 14 14 14 14 14 14 14 14 14 10 10 10 10 10 10 10 10 14 10 10 10 14 10 10 10 10 10 14 10 10 14 10 10 10 10 10 14 14 14 
14 14 14 10 10 10 10 14 14 14 14 10 10 10 10 10 10 14 14 14 14 10 10 10 10 10 10 10 10 10 10 10 10 10 10 10 10 10 10 10 10 10 10 10 10 10 10 14 14 14 
14 14 14 10 10 10 10 14 14 14 10 10 10 10 13 10 11 10 14 14 14 10 10 10 10 10 10 10 10 10 11 11 11 11 11 12 10 10 10 10 10 10 10 10 12 10 10 14 14 14 
14 14 14 10 13 10 14 14 14 10 10 15 16 16 16 17 10 10 10 10 14 10 10 10 10 10 10 11 11 11 11 11 11 11 11 11 10 10 10 10 10 10 10 10 10 10 10 14 14 14 
14 14 14 10 10 10 14 14 14 10 10 18 19 19 19 19 16 17 10 10 14 10 10 12 10 10 11 11 13 11 11 11 11 11 11 14 11 10 10 10 14 10 10 10 10 10 10 14 14 14 
14 14 14 10 10 10 14 14 14 10 10 18 19 19 19 19 19 20 10 10 10 10 10 10 10 11 11 11 11 11 11 11 11 11 11 11 11 11 11 11 11 10 10 10 10 10 10 14 14 14 
14 14 14 10 10 10 14 14 10 10 10 18 19 19 19 19 19 20 10 10 10 10 10 14 14 11 11 11 11 11 14 11 11 11 11 11 11 11 11 11 11 10 10 10 10 10 10 14 14 14 
14 14 14 10 10 10 14 14 12 10 10 21 19 19 19 19 19 23 10 10 10 10 14 14 10 11 11 11 11 11 11 11 11 11 11 11 11 11 11 11 11 10 10 10 14 10 10 14 14 14 
14 14 14 10 10 10 14 14 14 10 12 10 18 19 19 19 20 10 10 10 10 10 10 14 10 10 11 11 11 11 11 11 10 11 11 11 11 11 11 11 10 10 10 10 10 10 10 14 14 14 
14 14 14 10 10 10 10 14 14 14 10 10 21 22 22 22 23 10 10 10 10 10 10 10 10 11 11 11 11 11 11 10 10 10 12 11 11 11 11 10 10 10 14 10 10 10 10 14 14 14 
14 14 14 10 10 10 10 14 14 14 14 10 10 11 11 11 10 10 10 11 10 10 10 11 11 11 11 11 11 10 10 10 10 10 10 10 11 11 10 10 10 10 10 10 10 10 10 14 14 14 
14 14 14 10 10 10 10 14 14 14 14 14 10 10 10 10 10 10 10 10 10 10 10 10 11 11 11 11 10 10 15 16 16 16 16 16 17 10 10 10 10 13 10 10 10 10 10 14 14 14
14 14 14 10 10 10 10 10 14 14 14 14 14 14 14 14 10 10 10 10 14 10 10 10 11 11 10 10 10 15 19 19 19 19 19 19 19 16 16 16 17 10 10 10 10 10 10 14 14 14 
14 14 14 10 10 11 10 10 10 10 10 14 14 14 14 14 10 10 10 10 10 10 10 10 10 10 15 16 16 19 19 19 19 19 19 19 19 19 19 19 19 17 10 10 10 10 10 14 14 14 
14 14 14 10 10 11 11 10 10 10 10 10 10 10 12 13 10 10 10 10 10 10 11 10 10 10 18 19 19 19 19 19 19 19 19 19 19 19 19 19 19 19 17 10 10 10 10 14 14 14 
14 14 14 10 11 11 11 11 10 10 10 10 10 10 13 12 10 10 10 10 10 10 14 14 10 10 18 19 19 19 19 19 19 19 19 19 19 19 19 19 19 19 20 10 14 10 10 14 14 14 
14 14 14 10 10 11 14 10 10 14 14 14 14 14 14 14 10 10 10 10 10 10 14 14 10 10 18 19 19 19 19 19 19 19 19 19 19 19 19 19 19 19 20 14 14 14 10 14 14 14 
14 14 14 10 10 14 14 10 10 14 14 14 14 14 14 14 14 14 10 10 11 11 11 14 10 10 18 19 19 19 19 19 19 19 19 19 19 19 19 19 19 19 20 14 14 10 10 14 14 14 
14 14 14 10 13 14 14 10 11 10 10 10 10 10 10 10 14 14 14 10 10 10 11 11 11 10 21 22 19 19 19 19 19 19 19 19 19 19 19 19 19 19 20 10 14 10 10 14 14 14 
14 14 14 10 10 14 14 14 10 10 10 10 10 14 14 10 14 14 10 10 10 10 11 11 11 10 10 10 21 22 19 19 19 19 19 19 19 19 19 19 19 19 23 10 10 10 10 14 14 14 
14 14 14 10 10 14 14 14 14 14 14 10 14 14 14 10 10 10 11 14 10 10 11 11 11 11 11 10 10 10 21 19 19 19 19 19 19 19 22 22 22 23 10 10 10 10 10 14 14 14 
14 14 14 10 10 14 14 14 10 11 11 10 14 14 14 14 10 14 14 14 14 10 11 11 11 11 11 10 10 10 10 21 22 22 22 22 22 23 10 10 10 10 14 10 10 11 14 14 14 14 
14 14 14 10 10 10 14 14 10 14 14 14 14 14 10 14 10 14 14 14 14 10 11 11 11 11 11 10 10 10 14 10 10 10 10 10 10 10 10 14 14 14 14 11 11 11 14 14 14 14 
14 14 14 11 10 10 14 14 10 10 14 14 14 14 10 11 11 14 14 14 10 10 10 11 11 11 11 10 10 10 14 14 14 14 10 11 10 10 10 11 14 14 11 11 11 13 14 14 14 14
14 14 14 10 10 10 14 14 14 14 14 14 14 14 10 14 14 14 14 10 10 10 10 11 11 11 11 10 10 10 10 10 14 14 10 11 11 11 11 11 11 11 11 11 11 11 14 14 14 14 
14 14 14 14 10 10 10 10 14 14 14 14 10 10 11 14 14 10 10 10 10 14 10 11 11 11 10 10 10 10 10 10 10 10 10 10 11 11 11 11 12 11 11 11 11 14 14 14 14 14 
14 14 14 14 10 10 10 11 10 10 14 14 14 14 14 14 10 10 10 10 10 10 10 10 10 14 10 10 10 10 10 10 10 10 10 10 11 11 11 11 11 11 11 11 11 14 14 14 14 14 
14 14 14 14 14 10 10 10 10 13 10 10 10 10 10 10 10 10 10 10 10 10 10 10 10 10 10 10 10 10 10 10 10 10 11 11 11 11 11 11 11 11 11 14 14 14 14 14 14 14 
14 14 14 14 14 10 10 10 10 10 10 10 10 10 14 10 10 10 10 14 10 10 10 10 10 10 10 10 10 14 10 10 10 10 10 10 13 11 11 11 14 14 14 14 14 14 14 14 14 14 
14 14 14 14 14 14 14 14 10 10 10 11 10 10 10 10 10 10 10 10 10 10 10 10 10 10 10 10 10 10 10 10 10 10 10 10 11 11 14 14 14 14 14 14 14 14 14 14 14 14 
14 14 14 14 14 14 14 14 14 14 14 14 14 14 14 14 14 14 14 14 14 14 14 14 14 14 14 14 14 14 14 14 14 14 14 14 14 14 14 14 14 14 14 14 14 14 14 14 14 14 
14 14 14 14 14 14 14 14 14 14 14 14 14 14 14 14 14 14 14 14 14 14 14 14 14 14 14 14 14 14 14 14 14 14 14 14 14 14 14 14 14 14 14 14 14 14 14 14 14 14 
14 14 14 14 14 14 14 14 14 14 14 14 14 14 14 14 14 14 14 14 14 14 14 14 14 14 14 14 14 14 14 14 14 14 14 14 14 14 14 14 14 14 14 14 14 14 14 14 14 14 
